N= Normal
D= Devolução
T= Transferência
C= Complementar
I=  Importação
S= Sessão de Crédito ICMS
M= Mapa Resumo
B=Brinde
F=Frete/Conhecimento
G=Garantia/Troca
E=Entrega Futura
V=Venda a Ordem
R=Remessa
1=Genérico
2=Genérico
3=Genérico
4=Genérico
5=Genérico
A=Beneficiamento
H=Conserto
J=Consignação
K=Demonstração
O=Remessa 1
P=Remessa 2
Q=Remessa 3
U=Correção
6=Importação Drawback
7=Normal Drawback
8=Genérico
9=Genérico
0=Genérico
W=Genérico
X=Genérico
Y=Genérico
Z=Genérico
L=Genérico
